1111111111111111111111111111111111111111111111111111111111111111111111111111111
1                                                                             1
1                                                                             1
1                                                                             1
1                                                                             1
1             1111111111111 1111111111111                                     1
1             1           1 1           1                                     1
1             1           1 1           1                                     1
1             1           1 1           1                                     1
1             1           1 1           1                                     1
1  1121111111 1           1 1           1                                     1
1  1    1   1 1           1 1           1                                     1
1  1    2   2 2           2 2           1                                     1
1  1    1   1 1           1 1           1                                     1
1  1111111111 1111111111111 1111111111111                                     1
1                                                                             1
1                                                                             1
1                                                                             1
1111111111111111111111111111111111111111111111111111111111111111111111111111111
